team,bestScore,worstScore,totalScore,bestPoints,worstPoints,totalPoints,streak,beststreak,homeWins,homeLosses,homeTies,awayWins,awayLosses,awayTies,totalWins,totalLosses,totalTies
Alemannia Aachen,61,30,688,65,31,659,3,5,120,68,52,62,117,61,182,185,113
Bayreuth SpVgg,54,54,54,42,42,42,2,2,10,4,5,1,14,4,11,18,9
Blau-Weiß 1890 Berlin,55,46,101,56,49,105,2,3,18,4,16,6,15,17,24,19,33
Braunschweig,65,20,583,67,23,624,1,5,108,67,70,55,125,65,163,192,135
Darmstadt 98,48,26,453,59,25,450,3,4,71,53,64,41,97,50,112,150,114
Fortuna Köln,56,37,492,69,35,465,2,6,76,50,56,40,81,61,116,131,117
Hannover 96,93,31,1402,75,21,1308,1,6,225,134,143,122,255,124,347,389,267
Hertha BSC,82,34,1508,76,17,1512,1,6,256,140,138,155,238,141,411,378,279
Hessen Kassel,35,35,35,46,46,46,3,3,7,7,5,6,11,2,13,18,7
MSV Duisburg,70,31,1271,83,22,1241,1,5,203,132,136,120,215,136,323,347,272
Meppen,52,35,347,62,27,373,1,3,70,22,56,19,79,50,89,101,106
Preußen Münster,45,35,80,49,37,86,1,2,14,10,14,7,22,9,21,32,23
RW Essen,49,34,258,57,29,238,2,4,40,34,34,18,60,30,58,94,64
SC Freiburg,102,30,1535,92,18,1509,5,8,266,148,131,145,255,145,411,403,276
Saarbrücken,58,30,442,61,25,434,2,4,75,43,52,36,85,49,111,128,101
Schalke 04,74,18,1547,80,13,1647,1,6,280,119,149,168,224,154,448,343,303
Stuttgarter Kickers,68,31,486,72,34,492,2,5,90,46,48,41,92,51,131,138,99
Unterhaching,58,33,547,63,35,583,2,5,109,51,69,43,128,58,152,179,127
VfL Osnabrück,63,25,442,55,26,385,2,4,67,61,48,29,99,49,96,160,97
Wattenscheid 09,70,31,416,72,29,367,1,5,65,46,46,26,83,48,91,129,94
FC 08 Homburg,53,27,246,61,31,261,2,5,48,27,31,17,54,35,65,81,66
Havelse,44,44,44,25,25,25,1,1,6,9,4,0,16,3,6,25,7
Mainz 05,66,29,1449,64,26,1438,2,7,238,132,158,142,246,140,380,378,298
Schweinfurt,30,26,56,24,15,39,1,1,8,16,12,0,33,3,8,49,15
VfB Oldenburg,58,33,148,46,27,119,2,3,23,16,20,5,39,15,28,55,35
Waldhof Mannheim,66,27,557,76,25,567,3,5,113,45,50,34,98,76,147,143,126
1. FC Lokomotive Leipzig,66,29,290,80,20,295,1,5,52,27,40,24,68,27,76,95,67
1860 München,63,19,1117,66,23,1111,2,5,187,124,110,106,193,122,293,317,232
Chemnitzer,64,24,280,69,16,302,1,4,54,31,36,23,63,35,77,94,71
FC Carl Zeiss Jena,66,28,349,69,29,339,3,4,55,37,46,28,66,44,83,103,90
Hallescher FC,27,27,27,25,25,25,2,2,3,1,7,2,6,3,5,7,10
Rot-Weiss Erfurt,34,21,55,30,10,40,1,1,6,12,10,3,22,3,9,34,13
FC Remscheid,50,50,50,42,42,42,2,2,8,8,7,1,14,8,9,22,15
FC St. Pauli,72,31,1218,64,22,1210,3,5,203,119,142,111,227,126,314,346,268
Fortuna Düsseldorf,64,26,914,63,28,920,1,5,145,105,111,92,172,98,237,277,209
Hansa Rostock,66,30,875,65,27,867,3,4,158,102,90,69,185,96,227,287,186
Wolfsburg,80,33,1480,69,33,1419,4,10,245,113,139,136,226,137,381,339,276
Wuppertaler SV,55,44,99,61,41,102,1,3,20,12,10,6,22,14,26,34,24
KFC Uerdingen 05,49,33,345,65,26,340,1,5,53,58,44,30,78,47,83,136,91
Tennis Borussia,47,42,131,54,33,127,2,4,19,15,19,13,28,12,32,43,31
VfL Bochum,69,30,1528,69,27,1455,2,8,239,155,151,150,258,137,389,413,288
FSV Frankfurt,55,29,362,54,15,330,2,3,50,60,43,34,84,35,84,144,78
Nürnberg,68,26,1369,65,19,1353,1,7,222,154,150,135,259,132,357,413,282
Zwickau,39,32,137,49,28,154,3,5,31,17,20,8,43,17,39,60,37
Arminia Bielefeld,68,22,1026,68,20,983,1,8,165,122,102,89,179,119,254,301,221
VfB Lübeck,51,32,170,44,36,163,2,3,29,20,19,14,39,15,43,59,34
Eintracht Frankfurt,76,31,1591,68,32,1512,5,6,258,139,146,148,247,148,406,386,294
Gutersloh,43,39,125,55,37,137,1,3,26,6,19,9,29,13,35,35,32
Kaiserslautern,74,24,1439,68,23,1451,2,7,252,105,138,140,218,137,392,323,275
Energie Cottbus,65,30,721,58,25,716,1,4,136,90,63,54,152,83,190,242,146
Greuther Fürth,73,26,1158,70,21,1187,1,7,197,103,104,120,153,132,317,256,236
Karlsruher SC,69,27,1246,70,25,1240,2,5,207,124,144,113,225,136,320,349,280
Köln,84,26,1536,68,22,1443,2,6,235,164,144,151,251,141,386,415,285
Rot-Weiß Oberhausen,55,30,416,53,28,412,3,5,76,54,40,32,90,48,108,144,88
Ulm,63,36,141,58,34,127,3,3,21,15,15,12,26,13,33,41,28
B. Mönchengladbach,71,23,1587,66,21,1488,2,6,261,123,159,136,269,138,397,392,297
Kickers Offenbach FC,42,35,157,43,35,152,2,6,26,23,19,12,37,19,38,60,38
Reutlingen,64,43,160,53,39,136,3,4,28,16,7,11,28,12,39,44,19
Rot Weiss Ahlen,61,19,341,54,22,323,2,5,52,53,31,35,70,31,87,123,62
SV Babelsberg 03,39,39,39,18,18,18,2,2,3,14,0,1,10,6,4,24,6
Union Berlin,61,36,718,60,33,702,3,6,123,52,77,61,118,73,184,170,150
SV Eintracht Trier,53,39,138,48,39,132,2,3,22,15,14,13,25,13,35,40,27
SV Wacker Burghausen,48,40,223,48,32,216,2,4,27,26,32,27,36,22,54,62,54
Erzgebirge Aue,49,31,611,56,32,632,2,6,115,64,73,52,142,58,167,206,131
Jahn Regensburg,55,28,259,49,19,229,2,3,37,37,25,20,44,33,57,81,58
Dynamo Dresden,53,32,508,50,20,513,2,4,90,66,67,38,123,62,128,189,129
Paderborn,76,28,561,62,20,548,1,5,85,69,64,58,105,55,143,174,119
Siegen Sportfreunde ,35,35,35,31,31,31,2,2,5,7,5,3,12,2,8,19,7
FC Augsburg,60,29,647,65,32,646,2,5,102,78,72,68,120,64,170,198,136
TuS Koblenz,47,35,164,47,31,160,2,4,26,17,25,15,41,12,41,58,37
Hoffenheim,72,39,754,62,31,648,2,7,104,66,65,67,98,70,171,164,135
SV Wehen Burghausen,47,28,75,44,27,71,1,4,10,12,12,6,17,11,16,29,23
Ingolstadt 04,53,33,403,64,31,407,3,4,55,64,51,46,71,53,101,135,104
Sandhausen,45,29,332,44,25,346,1,3,51,48,51,36,79,34,87,127,85
VfR Aalen,40,34,110,46,33,123,2,3,18,17,16,12,22,17,30,39,33
Heidenheim,55,41,325,55,42,334,5,5,59,29,28,30,47,39,89,76,67
RB Leipzig,81,39,412,67,50,429,6,8,69,18,29,54,31,31,123,49,60
Stuttgart,78,32,1669,73,28,1594,2,8,282,136,125,157,234,152,439,370,277
Würzburger Kickers,32,30,62,34,20,54,1,3,7,11,13,5,21,5,12,32,18
Holstein Kiel,71,39,223,56,43,194,5,5,28,15,20,23,21,21,51,36,41
Hamburger SV,63,25,1479,68,27,1489,2,5,253,147,143,143,242,158,396,389,301
Magdeburg,35,35,35,31,31,31,2,2,2,5,10,4,10,3,6,15,13
Wehen Wiesbaden,45,45,45,34,34,34,2,2,4,9,4,5,9,3,9,18,7
B. Dortmund,84,41,1952,81,40,1894,4,8,330,86,126,206,178,160,536,264,286
B. Leverkusen,77,37,1893,73,38,1789,5,7,293,111,139,207,186,150,500,297,289
Bayern München,100,55,2380,91,49,2290,5,19,400,48,95,287,122,134,687,170,229
Werder Bremen,79,32,1752,74,30,1600,2,6,271,138,134,167,224,152,438,362,286
AFC Bournemouth,66,40,364,71,34,330,2,5,55,50,34,33,73,32,88,123,66
Barnsley,88,37,813,82,35,858,1,9,150,85,81,82,152,81,232,237,162
Blackburn Rovers,80,32,1305,91,31,1370,2,7,232,125,126,137,210,137,369,335,263
Bradford City,82,30,445,87,26,438,1,4,77,71,51,37,117,45,114,188,96
Brighton & Hove Albion,63,33,405,70,33,417,2,5,63,67,58,43,103,41,106,170,99
Hull City,58,33,296,58,30,274,2,4,42,57,42,23,81,37,65,138,79
Ipswich Town,85,35,1029,87,27,1061,4,6,184,91,79,106,136,112,290,227,191
Leeds United,79,28,957,85,33,1028,3,7,172,74,89,110,133,93,282,207,182
Leicester,73,30,1265,92,28,1280,3,8,207,130,130,135,209,124,342,339,254
Middlesbrough,77,27,1082,91,28,1160,1,6,201,129,115,104,212,130,305,341,245
Newcastle,92,32,1606,96,32,1635,1,11,293,143,150,150,281,156,443,424,306
Oldham Athletic AFC,83,42,486,88,40,459,2,5,86,39,53,34,98,46,120,137,99
Oxford United,69,53,245,61,50,221,2,3,36,27,29,20,48,24,56,75,53
Plymouth Argyle,58,42,206,55,48,209,3,4,39,22,31,14,59,19,53,81,50
Port Vale,62,42,484,67,36,480,1,4,81,71,55,39,103,65,120,174,120
Portsmouth,97,34,1149,98,28,1156,1,7,208,133,114,97,231,127,305,364,241
Sheffield United,78,17,1067,85,14,1132,1,5,195,105,112,106,188,117,301,293,229
Stoke City,60,34,879,73,33,1039,1,4,185,123,109,81,205,132,266,328,241
Sunderland,91,21,1300,105,15,1399,2,8,227,167,159,142,278,133,369,445,292
Swindon Town,79,38,579,76,30,539,2,4,96,74,58,42,119,67,138,193,125
Watford,76,29,1089,82,24,1118,3,6,182,144,127,112,231,109,294,375,236
West Bromwich Albion,69,28,1208,89,24,1231,2,5,198,178,144,115,256,148,313,434,292
West Ham,81,35,1555,88,33,1624,4,5,281,178,153,154,291,166,435,469,319
Wolves,81,31,1253,86,25,1310,2,6,211,123,140,132,202,141,343,325,281
Bristol City,68,40,358,67,42,378,4,4,67,46,46,31,89,38,98,135,84
Bristol Rovers,60,55,171,62,41,161,4,4,28,19,22,13,40,16,41,59,38
Charlton Athletic,80,31,920,91,30,1012,2,8,165,109,104,105,175,98,270,284,202
Millwall,70,39,674,77,26,754,1,5,126,68,76,73,115,81,199,183,157
Notts County,76,40,281,80,40,280,2,7,54,32,27,20,62,31,74,94,58
Sheffield Wednesday,80,34,777,82,31,782,2,7,125,90,95,78,155,78,203,245,173
Cambridge United,65,48,113,74,49,123,2,3,18,13,15,12,16,18,30,29,33
Derby County,73,20,907,79,11,927,1,5,159,127,90,89,193,93,248,320,183
Grimsby Town,62,40,556,65,39,596,2,4,98,75,80,55,141,57,153,216,137
Southend United,63,42,328,62,39,333,1,4,61,40,37,27,79,32,88,119,69
Tranmere Rovers,72,46,611,79,38,619,2,4,110,52,68,51,111,68,161,163,136
Birmingham City,70,28,839,81,34,958,2,5,162,98,101,88,165,107,250,263,208
Brentford,71,52,123,73,49,122,6,6,17,12,13,16,18,10,33,30,23
Luton Town,61,35,363,58,37,382,3,3,65,50,55,30,100,42,95,150,97
Peterborough United,55,48,103,62,37,99,2,3,13,13,20,11,28,7,24,41,27
Bolton Wanderers,100,36,1028,98,29,1048,4,7,174,97,114,104,181,100,278,278,214
Crystal Palace,78,31,1225,90,33,1279,2,6,185,165,145,154,223,117,339,388,262
Nottingham Forest,82,31,942,94,30,988,3,5,157,90,115,101,163,99,258,253,214
Oxford City,64,48,226,58,44,208,3,4,43,27,22,12,59,21,55,86,43
Burnley,70,25,590,75,30,645,1,5,109,91,68,61,139,67,170,230,135
Reading,61,39,568,79,28,638,2,6,113,71,54,64,122,53,177,193,107
Huddersfield Town,62,22,424,74,16,450,1,5,81,66,50,33,105,58,114,171,108
Norwich City,79,26,1113,94,21,1197,1,9,199,118,146,115,240,109,314,358,255
Man. City,108,29,2007,100,34,1998,13,18,351,138,121,223,231,155,574,369,276
Queens Park Rangers,64,30,852,66,25,844,1,7,136,111,110,77,184,95,213,295,205
Bury,42,35,77,52,47,99,1,2,16,13,17,5,22,19,21,35,36
Crewe Alexandra,66,46,375,59,48,365,3,4,63,61,37,34,90,37,97,151,74
Stockport County,71,42,275,65,26,249,1,4,40,40,35,21,63,31,61,103,66
Fulham,90,24,767,101,26,806,2,8,149,104,75,60,163,104,209,267,179
Walsall,57,45,205,54,46,202,2,3,35,35,22,17,51,24,52,86,46
Gillingham,64,45,274,64,50,282,2,3,51,40,24,22,54,39,73,94,63
Preston North End,71,41,381,78,48,394,3,4,66,31,39,43,64,28,109,95,67
Wimbledon FC,76,34,788,69,29,785,1,7,116,100,93,84,133,92,200,233,185
Coventry City,67,35,772,66,34,821,2,6,135,109,104,72,180,96,207,289,200
Rotherham United,62,35,243,59,29,230,2,3,30,41,40,24,59,28,54,100,68
Cardiff City,68,32,239,65,30,242,2,5,38,45,22,25,48,31,63,93,53
Wigan Athletic,79,34,455,87,36,489,2,6,72,68,58,56,95,47,128,163,105
Swansea City,54,28,356,75,33,387,2,4,62,49,42,42,79,33,104,128,75
Wycombe Wanderers,30,30,30,33,33,33,2,2,5,11,5,3,13,4,8,24,9
BV Veendam ,68,0,276,102,0,208,0,34,34,106,106,0,0,0,34,106,106
Dordrecht,114,0,606,114,0,756,1,38,197,131,125,8,44,16,205,175,141
Emmen,136,0,735,114,0,655,2,38,156,127,155,7,27,11,163,154,166
FC Eindhoven,152,0,526,136,0,700,0,38,140,68,178,34,0,0,174,68,178
Go Ahead Eagles,228,0,999,114,0,866,2,38,241,164,61,19,75,25,260,239,86
HFC Haarlem ,114,0,542,114,0,471,1,38,117,155,113,1,12,4,118,167,117
Helmond Sport,170,29,677,114,0,469,0,38,110,106,139,0,0,0,110,106,139
Heracles,238,32,1291,114,0,1105,2,38,261,152,95,57,152,56,318,304,151
MVV Maastricht,136,34,932,136,0,788,1,38,158,121,154,30,87,70,188,208,224
ADO Den Haag,136,0,1182,102,16,1050,1,34,215,128,126,69,193,72,284,321,198
PEC Zwolle,136,0,840,102,0,796,1,34,173,97,122,37,100,44,210,197,166
SC Telstar,114,34,556,114,0,386,0,38,106,136,68,0,0,0,106,136,68
Den Bosch,76,0,346,114,0,319,1,38,62,105,96,5,58,22,67,163,118
Groningen,204,27,1556,102,31,1423,4,34,263,135,140,121,251,131,384,386,271
TOP Oss,190,0,630,114,0,545,0,38,169,144,38,0,0,0,169,144,38
VVV Venlo,190,24,911,114,0,756,2,38,161,153,155,27,116,37,188,269,192
RBC Roosendaal,114,22,350,114,0,359,1,38,96,79,20,15,64,6,111,143,26
Cambuur,76,0,508,114,0,601,2,38,143,89,103,12,74,33,155,163,136
FC Volendam,152,29,783,114,0,697,1,38,144,98,127,30,109,48,174,207,175
Fortuna Sittard,114,0,984,114,0,909,2,38,192,193,147,44,133,54,236,326,201
AGOVV Apeldoorn,114,0,398,114,0,330,0,38,110,110,0,0,0,0,110,110,0
Sparta Rotterdam,228,26,1270,114,24,1033,2,38,213,136,128,58,218,92,271,354,220
Excelsior,76,0,683,114,0,583,2,38,114,120,117,29,104,37,143,224,154
FC Omniworld,76,38,152,38,0,38,0,0,0,76,38,0,0,0,0,76,38
De Graafschap,136,0,861,102,0,787,1,34,180,149,78,40,183,49,220,332,127
Almere City,102,0,178,102,0,136,0,34,34,72,34,0,0,0,34,72,34
Jong Ajax,76,0,76,114,0,114,0,38,38,34,0,0,0,0,38,34,0
Jong Twente,114,114,114,114,114,114,38,38,38,0,0,0,0,0,38,0,0
Willem II,76,29,1420,65,15,1218,1,7,219,178,144,98,283,123,317,461,267
Jong AZ,0,0,0,29,29,29,0,0,0,0,29,0,0,0,0,0,29
Jong PSV,58,34,92,29,0,29,0,0,0,34,29,0,0,0,0,34,29
NEC Nijmegen,57,27,997,51,0,918,2,5,155,178,104,80,219,109,235,397,213
Roda JC,70,26,1451,76,29,1344,3,6,232,126,147,125,225,126,357,351,273
Jong Utrecht,34,34,34,0,0,0,0,0,0,34,0,0,0,0,0,34,0
NAC Breda,204,29,1239,102,23,1054,1,34,186,133,106,99,199,93,285,332,199
Ajax,119,55,2652,89,56,2365,7,14,415,44,77,306,106,125,721,150,202
Feyenoord,90,39,2108,82,40,2018,3,13,358,73,106,232,163,142,590,236,248
PSV,105,54,2612,88,49,2359,3,13,424,38,74,291,108,140,715,146,214
RKC Waalwijk,51,27,1015,59,15,916,2,5,154,141,107,85,224,92,239,365,199
Twente 1965,82,34,1662,86,24,1632,2,12,280,108,132,171,203,147,451,311,279
Utrecht,60,27,1539,63,28,1479,3,6,259,127,151,139,263,134,398,390,285
Vitesse,85,37,1701,70,28,1629,5,8,266,117,155,180,221,136,446,338,291
Heerenveen,88,35,1626,68,33,1422,3,6,236,125,126,154,206,126,390,331,252
SVV,31,31,31,32,32,32,1,1,7,5,5,1,13,3,8,18,8
AZ Alkmaar,83,27,1435,80,25,1328,4,11,220,95,87,166,151,83,386,246,170
Lille,72,26,1465,114,35,1875,7,38,344,112,162,164,225,189,508,337,351
Metz,60,0,1207,81,24,1523,7,7,257,148,185,131,247,174,388,395,359
Montpellier,152,28,1515,114,31,1668,4,38,311,133,168,129,263,180,440,396,348
Nantes,76,28,1375,114,28,1685,3,38,305,127,177,144,266,161,449,393,338
Nice,114,30,1301,78,23,1502,3,7,249,129,208,125,249,172,374,378,380
Olympique Lyonnais,87,25,1820,84,0,2005,5,9,343,111,154,224,198,150,567,309,304
Racing Paris,0,0,0,38,38,38,0,0,0,0,38,0,0,0,0,0,38
Sochaux,67,24,1307,114,23,1602,3,38,298,154,169,119,282,182,417,436,351
Sporting Toulon Var,76,31,272,114,31,334,2,38,78,30,29,14,56,29,92,86,58
Toulouse,114,22,1315,114,13,1535,4,38,274,153,172,127,276,160,401,429,332
Auxerre,66,28,1432,72,34,1644,2,6,296,122,153,143,254,174,439,376,327
Caen,65,27,1402,81,33,1574,2,7,279,148,158,131,268,186,410,416,344
Cannes,56,25,386,60,28,444,2,5,80,48,60,31,106,51,111,154,111
Girondins Bordeaux,66,34,1434,80,36,1694,3,11,302,91,158,151,225,177,453,316,335
Monaco,107,36,1705,95,36,1903,5,12,321,96,155,206,197,167,527,293,322
Nancy,64,27,1278,76,34,1507,4,4,253,149,164,134,250,182,387,399,346
Olympique Marseille,80,31,1696,84,40,1960,5,8,350,91,134,197,193,185,547,284,319
PSG,108,34,1866,96,39,2046,7,14,353,81,137,228,176,166,581,257,303
Saint-Étienne,60,27,1346,73,30,1592,5,7,276,119,186,137,277,167,413,396,353
Stade Brestois,64,31,763,74,29,909,7,7,152,80,102,83,149,102,235,229,204
Stade Rennais,57,25,1318,73,35,1515,4,8,265,133,156,133,256,165,398,389,321
Le Havre,66,23,1230,78,26,1488,2,5,251,123,182,127,257,172,378,380,354
Lens,59,32,1327,68,29,1582,4,7,257,111,184,153,231,168,410,342,352
Nîmes,75,29,934,73,25,979,6,6,158,111,128,91,202,104,249,313,232
Strasbourg,63,28,1004,70,29,1084,4,5,193,102,125,84,209,128,277,311,253
Valenciennes,52,24,754,74,29,817,2,9,135,91,110,70,174,92,205,265,202
Angers SCO,52,28,798,64,25,933,2,4,148,102,126,83,179,114,231,281,240
FC Martigues,54,30,258,67,32,300,1,3,52,39,46,17,73,47,69,112,93
Bastia,61,29,968,74,35,1115,4,5,225,98,106,74,243,112,299,341,218
FC Gueugnon,62,27,630,78,27,758,2,6,125,64,104,63,140,90,188,204,194
Guingamp,63,28,1085,79,27,1255,2,6,211,119,152,111,234,137,322,353,289
Chateauroux,56,22,1037,76,21,1219,1,5,204,111,156,105,230,136,309,341,292
Lorient,68,32,1203,75,31,1347,5,5,226,118,144,131,225,132,357,343,276
Sedan,59,34,771,71,31,866,1,8,146,68,107,72,144,105,218,212,212
Troyes,61,23,1032,78,18,1213,4,8,214,116,116,111,213,122,325,329,238
Ajaccio,62,27,887,72,23,1072,2,5,188,113,128,83,215,131,271,328,259
Le Mans,54,30,893,68,26,1059,2,6,177,91,136,89,190,125,266,281,261
Istres,48,25,449,66,32,520,2,5,92,64,74,34,128,68,126,192,142
Grenoble,51,24,502,63,23,592,3,4,96,59,84,48,115,76,144,174,160
Boulogne,51,31,194,66,31,228,2,6,39,35,21,20,45,30,59,80,51
Arles,43,21,201,60,20,250,1,2,41,32,41,15,58,41,56,90,82
Dijon FCO,62,20,745,70,15,825,6,6,140,83,92,70,142,103,210,225,195
Evian Thonon Gaillard,63,39,284,67,37,277,3,3,44,40,30,28,55,31,72,95,61
Stade de Reims,74,26,718,88,35,819,7,7,136,83,95,69,138,109,205,221,204
Gazélec Ajaccio,49,30,232,65,28,261,2,4,41,38,35,24,59,31,65,97,66
Amiens SC,59,26,796,69,23,932,2,6,154,100,126,75,184,119,229,284,245
Beauvais Oise,50,20,316,61,37,382,3,4,60,41,59,28,73,59,88,114,118
Bourges 18,46,46,46,42,42,42,2,2,8,5,8,2,15,4,10,20,12
Charleville,45,34,157,56,48,205,1,3,28,21,35,18,34,32,46,55,67
Dunkerque,44,26,142,60,34,192,1,5,31,17,30,14,38,27,45,55,57
FC Mulhouse,51,44,244,54,41,248,3,4,47,20,38,14,64,27,61,84,65
FC Rouen 1899,45,27,72,52,29,81,1,2,14,15,11,6,24,10,20,39,21
Niort,58,30,945,65,26,1088,2,5,172,100,167,86,206,147,258,306,314
Olympique Alès,47,29,120,54,25,132,1,2,19,12,32,10,40,13,29,52,45
Red Star,61,28,432,70,30,480,1,5,79,49,53,45,81,55,124,130,108
Stade Briochin,53,32,123,65,38,146,2,3,28,18,17,10,38,15,38,56,32
Stade Lavallois,56,33,919,69,30,1024,1,4,182,101,126,70,197,142,252,298,268
Valence,51,34,387,58,33,426,2,3,75,43,63,25,93,63,100,136,126
Perpignan,44,35,117,61,44,156,3,4,26,12,25,11,32,20,37,44,45
CS Louhans Cuiseaux,57,32,169,58,24,182,1,2,35,25,22,12,51,19,47,76,41
Stade Poitevin,36,36,36,46,46,46,2,2,8,4,9,1,10,10,9,14,19
Épinal,42,26,68,48,26,74,1,2,14,15,13,2,27,13,16,42,26
ES Wasquehal,49,26,223,51,36,264,3,4,44,28,44,18,64,34,62,92,78
Creteil,57,33,452,54,34,484,2,4,79,50,80,32,106,71,111,156,151
Clermont,56,31,777,63,38,893,4,4,145,83,105,79,139,116,224,222,221
Besancon RC,37,37,37,38,38,38,2,2,5,6,8,3,10,6,8,16,14
Sète,31,31,31,23,23,23,1,1,4,8,7,0,15,4,4,23,11
FC Libourne Saint Seurin,43,41,84,44,32,76,2,2,13,15,10,6,23,9,19,38,19
Tours,63,29,499,61,23,502,1,4,88,64,57,39,106,64,127,170,121
Vannes,40,34,113,51,44,141,4,4,21,15,21,16,32,9,37,47,30
CA Bastia,21,21,21,24,24,24,1,1,2,8,9,2,14,3,4,22,12
Orléans,52,21,201,52,19,199,1,6,29,33,28,22,50,18,51,83,46
Bourg-Péronnas,50,47,146,47,36,127,2,4,23,21,13,11,34,12,34,55,25
Paris FC,46,22,180,65,28,239,5,5,34,21,31,25,32,31,59,53,62
Quevilly,45,45,45,33,33,33,2,2,5,12,2,4,11,4,9,23,6
Béziers,33,33,33,38,38,38,1,1,3,7,9,6,11,2,9,18,11
Chambly,33,26,59,35,28,63,1,2,9,16,6,6,11,12,15,27,18
Rodez,32,31,63,38,32,70,2,2,12,9,9,4,13,13,16,22,22
Pau FC,32,32,32,35,35,35,2,2,7,5,4,2,10,4,9,15,8
Arsenal,87,40,2153,90,45,2275,3,13,394,76,142,259,180,174,653,256,316
Aston Villa,71,27,1352,74,17,1473,4,6,234,161,159,151,246,159,385,407,318
Chelsea,103,46,2055,95,49,2213,4,13,368,88,156,267,194,152,635,282,308
Everton,64,34,1601,72,39,1687,4,8,288,157,167,159,274,179,447,431,346
Liverpool,101,47,2114,99,52,2219,3,18,386,82,145,252,200,160,638,282,305
Man. Utd,97,46,2283,92,48,2483,4,11,422,69,121,312,141,160,734,210,281
Southampton,71,34,1193,63,32,1168,3,6,196,151,132,108,247,124,304,398,256
Tottenham Hotspur,86,44,1827,86,44,1864,4,10,322,146,144,198,254,160,520,400,304
Blackpool,55,55,55,39,39,39,4,4,5,9,5,5,10,4,10,19,9
Beira Mar SC,84,0,668,49,0,642,0,6,106,195,147,35,159,72,141,354,219
Belenenses,126,0,1198,126,23,1367,42,42,261,141,181,92,228,127,353,369,308
Benfica,103,45,2118,101,52,2286,6,16,387,40,99,303,106,117,690,146,216
Boavista,63,24,1140,90,25,1370,30,30,262,95,109,111,183,142,373,278,251
Chaves,102,0,693,102,0,642,0,34,113,89,160,32,127,47,145,216,207
Estrela Amadora,42,0,488,50,17,592,0,4,100,67,118,32,141,78,132,208,196
Feirense,68,0,382,90,0,464,0,30,107,97,89,13,55,15,120,152,104
Marítimo,56,22,1217,56,24,1397,2,5,264,121,141,108,278,140,372,399,281
Nacional,102,22,936,102,21,962,24,34,189,83,129,66,171,68,255,254,197
Penafiel,84,0,475,126,0,802,28,42,226,131,73,10,73,21,236,204,94
Portimonense,126,0,557,126,0,556,0,42,144,138,68,11,62,23,155,200,91
Porto,85,39,2175,98,60,2483,7,16,439,27,60,328,76,122,767,103,182
Sporting Braga,74,32,1436,75,36,1618,6,13,308,110,108,144,228,154,452,338,262
Sporting CP,79,35,1803,86,42,2119,6,11,370,60,96,255,123,148,625,183,244
Tirsense,39,21,152,48,31,197,2,3,41,19,27,7,54,26,48,73,53
União Madeira,90,0,385,126,29,490,42,42,108,26,110,12,72,20,120,98,130
Vitória Guimarães,60,28,1336,90,34,1557,30,30,287,129,125,148,236,127,435,365,252
Vitória Setúbal,102,21,1055,102,22,1137,34,34,231,150,115,69,237,122,300,387,237
Famalicão,76,26,271,114,27,345,38,38,78,26,34,17,57,26,95,83,60
Farense,72,24,637,138,22,830,24,46,210,49,64,28,139,52,238,188,116
Gil Vicente,90,23,1130,126,19,1379,42,42,334,105,139,54,202,76,388,307,215
SC Salgueiros,49,27,459,52,30,489,2,6,88,57,61,37,116,53,125,173,114
Estoril,136,0,749,102,0,836,28,34,198,86,102,32,90,44,230,176,146
Paços de Ferreira,68,27,880,102,24,989,34,34,179,101,142,72,188,94,251,289,236
Torreense,36,34,70,102,35,137,34,34,42,4,5,0,11,6,42,15,11
Espinho,102,27,337,102,0,240,0,34,46,48,76,6,20,8,52,68,84
União de Leiria,52,25,569,56,16,656,1,6,113,77,72,57,131,74,170,208,146
Campomaiorense,53,29,186,40,32,178,1,3,38,26,21,10,62,13,48,88,34
FC Felgueiras,68,0,131,102,0,135,0,34,40,142,5,2,11,4,42,153,9
Leça FC,68,0,159,38,0,176,0,3,20,52,81,8,32,11,28,84,92
Rio Ave,50,0,698,55,28,898,0,4,124,98,200,79,156,89,203,254,289
Académica,102,25,742,102,21,793,24,34,165,90,93,45,141,70,210,231,163
Varzim,114,0,539,114,0,553,28,38,154,161,68,4,36,11,158,197,79
Alverca,45,33,226,43,27,215,0,3,36,36,47,12,49,24,48,85,71
CD Santa Clara,102,0,574,126,0,805,42,42,171,108,205,21,53,24,192,161,229
Desportivo Aves,92,0,668,138,0,917,42,46,283,232,16,12,55,16,295,287,32
Moreirense,84,0,549,126,0,722,42,42,161,126,64,44,94,43,205,220,107
Naval,102,0,336,39,0,224,0,3,27,145,60,21,51,20,48,196,80
Leixões,126,0,468,126,21,640,0,42,160,14,123,9,26,10,169,40,133
Trofense,90,0,175,90,23,215,0,30,33,7,107,2,10,3,35,17,110
Olhanense,92,21,476,138,0,527,0,46,129,71,73,13,34,28,142,105,101
Arouca,47,26,134,54,28,145,2,3,24,29,13,13,32,21,37,61,34
Tondela,84,25,329,138,28,379,46,46,78,46,62,20,55,23,98,101,85
Athletic,72,37,1564,70,37,1683,1,5,303,142,163,147,291,170,450,433,333
Atlético,80,40,1904,90,38,2079,5,9,370,103,139,222,226,164,592,329,303
Barcelona,116,60,2778,100,56,2575,7,16,464,51,93,314,146,148,778,197,241
CD Castellón,55,27,430,65,33,520,2,5,94,60,63,37,116,64,131,176,127
CD Logroñés,69,15,445,69,15,501,2,4,83,67,67,45,122,50,128,189,117
CD Málaga,52,23,100,62,37,139,2,3,23,16,18,12,29,16,35,45,34
Celta,83,24,1546,85,27,1666,7,7,273,155,192,161,287,172,434,442,364
Cádiz,68,27,672,76,22,791,5,7,121,82,115,75,155,88,196,237,203
Mallorca,69,30,1493,71,33,1650,5,7,294,140,164,150,292,154,444,432,318
Osasuna,59,25,1317,87,22,1577,4,5,274,166,178,136,313,169,410,479,347
R. Sociedad,71,32,1620,76,35,1721,3,6,299,135,180,158,286,170,457,421,350
Rayo Vallecano,73,31,1398,79,25,1437,3,6,247,163,141,134,265,153,381,428,294
Real Madrid,121,53,2646,100,62,2521,4,13,455,70,83,307,149,152,762,219,235
Real Oviedo,54,35,880,65,40,1006,3,5,180,91,125,72,199,125,252,290,250
Real Sporting,63,31,1484,82,13,1690,4,8,289,176,177,157,310,175,446,486,352
Real Valladolid,70,25,1444,88,27,1623,3,7,273,160,193,145,305,176,418,465,369
Real Zaragoza,79,29,1597,81,34,1693,2,6,298,158,172,147,295,186,445,453,358
Sevilla,75,38,1766,80,28,1892,4,7,350,129,135,184,275,155,534,404,290
Tenerife,79,30,1462,81,34,1579,3,6,277,131,198,127,309,169,404,440,367
Valencia,77,37,1851,83,34,1976,1,8,355,110,143,201,242,165,556,352,308
Espanyol,63,27,1464,74,25,1599,5,6,289,164,157,133,301,176,422,465,333
Real Betis,85,33,1614,84,25,1761,5,6,297,147,172,175,268,173,472,415,345
Real Burgos CF,53,29,192,68,26,226,1,3,45,25,25,9,47,39,54,72,64
Albacete,60,21,1204,71,28,1381,3,4,226,152,169,126,265,156,352,417,325
Deportivo,76,31,1591,91,29,1807,7,9,314,127,160,176,248,177,490,375,337
Lleida,66,29,617,80,28,703,2,6,127,69,63,60,120,79,187,189,142
Racing,58,28,1099,75,27,1175,1,7,187,162,138,113,237,137,300,399,275
Compostela,60,35,531,70,44,582,3,3,98,60,63,51,98,72,149,158,135
Mérida CP,58,33,419,79,39,512,4,9,88,35,54,47,77,53,135,112,107
UD Salamanca,72,29,876,71,27,932,3,4,154,110,102,85,168,113,239,278,215
CF Extremadura,60,27,333,79,39,428,1,5,77,38,47,33,78,51,110,116,98
Hércules,82,36,751,78,35,837,3,6,147,84,76,75,137,95,222,221,171
Alavés,62,24,975,82,24,1158,5,7,192,123,117,121,209,102,313,332,219
Villarreal,69,29,1462,77,36,1633,5,8,286,121,146,157,238,158,443,359,304
Málaga,72,24,1076,79,20,1172,2,7,194,131,120,116,207,122,310,338,242
Numancia,68,30,1127,77,29,1251,3,6,224,113,138,96,226,153,320,339,291
Las Palmas,73,24,1298,78,22,1379,3,6,239,123,162,112,248,164,351,371,326
Recreativo,67,34,803,78,33,972,2,6,150,100,118,97,158,113,247,258,231
Real Murcia,62,29,767,79,26,887,2,5,153,88,104,74,169,102,227,257,206
Getafe,58,22,974,76,30,1098,3,4,181,131,132,101,221,120,282,352,252
Levante,63,27,1192,84,26,1316,5,7,224,131,155,113,247,150,337,378,305
Gimnàstic Tarragona,60,30,579,76,28,664,1,4,102,89,80,68,129,74,170,218,154
Almería,73,35,1011,80,30,1100,5,5,190,108,123,97,208,116,287,316,239
Xerez,73,24,684,82,30,793,3,7,129,90,90,73,139,97,202,229,187
Granada,71,29,475,79,20,522,4,4,95,65,51,45,115,51,140,180,102
Elche,67,27,1122,82,26,1272,2,5,206,125,158,119,233,139,325,358,297
Córdoba,59,22,824,71,20,932,1,5,155,115,106,84,183,109,239,298,215
Eibar,56,19,1021,73,23,1324,3,5,213,140,180,108,244,181,321,384,361
Leganés,59,30,744,74,35,892,4,4,137,102,119,84,164,110,221,266,229
Girona,74,34,673,82,37,747,2,5,124,61,80,74,118,73,198,179,153
Huesca,61,31,508,75,27,579,2,5,93,60,70,54,101,68,147,161,138
Atlético B,73,33,270,74,37,268,5,5,45,26,30,25,48,28,70,74,58
Bilbao Ath.,50,33,326,60,32,354,2,4,59,42,53,26,82,46,85,124,99
Palamós,52,29,226,53,38,273,1,3,44,25,45,22,62,30,66,87,75
RM Castilla,80,36,565,65,41,578,4,4,101,64,52,56,106,55,157,170,107
Sabadell,54,30,359,59,32,414,2,4,77,46,54,28,104,45,105,150,99
Sestao Sport Club,36,26,153,49,31,212,2,6,30,28,37,20,50,25,50,78,62
UE Figueres,44,37,165,63,43,207,3,3,38,17,21,15,34,27,53,51,48
Orihuela CF,46,46,46,55,55,55,2,2,10,2,7,2,5,12,12,7,19
Real Avilés,35,31,66,48,36,84,1,3,13,6,19,6,24,8,19,30,27
Barcelona B,85,40,772,71,34,670,3,4,108,83,70,69,123,69,177,206,139
Atlético Marbella,45,28,155,59,21,172,1,3,33,25,18,11,43,22,44,68,40
CD Badajoz,48,32,432,63,38,569,2,7,78,63,80,62,90,69,140,153,149
Lugo,49,23,405,56,32,490,3,4,85,56,63,34,100,70,119,156,133
CD Toledo,54,34,305,65,40,381,2,4,61,42,36,40,57,42,101,99,78
CD Ourense,37,26,133,49,24,144,2,3,24,32,24,10,52,18,34,84,42
Écija Balompié,34,27,61,45,30,75,2,3,12,14,12,7,25,6,19,39,18
Real Jaén,43,30,149,59,42,194,2,3,32,27,25,15,41,28,47,68,53
Mallorca B,52,52,52,46,46,46,2,2,6,6,9,6,14,1,12,20,10
Racing Ferrol,58,40,289,56,37,288,3,4,41,44,41,29,60,37,70,104,78
Universidad LPGC,34,34,34,39,39,39,2,2,5,7,9,3,12,6,8,19,15
Burgos,31,31,31,52,52,52,3,3,4,7,10,8,7,6,12,14,16
Poli Ejido,52,29,279,58,44,358,2,4,62,40,45,28,76,43,90,116,88
Terrassa FC,45,41,131,52,44,146,2,3,24,18,21,11,32,20,35,50,41
Algeciras,39,39,39,33,33,33,2,2,5,9,7,1,12,8,6,21,15
At. Malagueño,46,33,121,49,36,133,2,3,17,23,23,14,32,17,31,55,40
Ciudad de Murcia,53,49,205,72,47,231,3,5,38,21,25,21,34,29,59,55,54
Pontevedra,52,52,52,44,44,44,3,3,6,6,9,4,12,5,10,18,14
Lorca Deportiva,56,37,93,69,37,106,2,5,18,12,12,10,22,10,28,34,22
Ponferradina,57,36,360,66,34,404,3,6,73,40,51,28,86,50,101,126,101
Vecindario,42,42,42,34,34,34,3,3,7,10,4,2,16,3,9,26,7
Granada 74,45,45,45,45,45,45,4,4,7,4,10,3,13,5,10,17,15
Sevilla At.,55,29,156,56,19,160,2,4,25,26,33,11,54,19,36,80,52
Alicante,38,38,38,35,35,35,1,1,2,12,7,6,11,4,8,23,11
FC Cartagena,58,34,177,65,35,196,2,3,33,25,22,18,41,21,51,66,43
Real Unión de Irún,40,40,40,46,46,46,2,2,8,6,7,4,14,3,12,20,10
Villarreal B,60,43,157,61,51,164,3,4,26,20,17,19,32,12,45,52,29
Alcorcón,58,24,491,73,35,623,3,6,108,57,62,58,106,63,166,163,125
Alcoyano,46,46,46,37,37,37,2,2,6,8,7,3,15,3,9,23,10
CD Guadalajara,50,46,96,50,49,99,2,2,16,17,9,10,20,12,26,37,21
Mirandés,55,31,297,59,41,354,3,4,54,38,50,35,70,37,89,108,87
Llagostera,44,41,85,57,44,101,2,3,20,13,9,7,24,11,27,37,20
Reus Deportiu,31,16,78,55,21,128,1,2,15,23,25,15,35,13,30,58,38
UCAM Murcia,42,42,42,48,48,48,2,2,7,8,6,4,8,9,11,16,15
Cultural Leonesa,54,54,54,48,48,48,2,2,9,4,8,2,12,7,11,16,15
Lorca FC,37,37,37,33,33,33,1,1,7,8,6,1,17,3,8,25,9
Extremadura,43,43,86,53,43,96,3,5,13,21,8,11,15,16,24,36,24
Rayo Majadahonda,46,46,46,45,45,45,2,2,8,7,6,4,14,3,12,21,9
Fuenlabrada,47,36,83,60,43,103,2,3,12,8,18,12,13,13,24,21,31
UD Logroñés,25,25,25,39,39,39,6,6,6,7,3,4,8,6,10,15,9
Academico Viseu,76,0,156,138,0,382,0,46,118,42,28,0,0,0,118,42,28
FC Maia,136,34,476,102,0,374,0,34,102,34,68,0,0,0,102,34,68
Uniao Lamas,136,0,238,102,0,238,0,34,68,34,34,0,0,0,68,34,34
SC Freamunde,170,0,370,138,0,450,0,46,140,76,30,0,0,0,140,76,30
SP. Covilhã,68,0,214,102,0,298,24,34,88,72,34,0,0,0,88,72,34
FC Marco,68,0,136,102,0,102,0,34,34,102,0,0,0,0,34,102,0
Ovarense,136,34,272,102,34,238,0,34,68,0,34,0,0,0,68,0,34
Gondomar,102,30,226,102,0,234,0,34,68,30,30,0,0,0,68,30,30
Vizela,150,56,308,102,84,276,28,34,92,0,0,0,0,0,92,0,0
Fatima,60,60,60,90,90,90,30,30,30,0,0,0,0,0,30,0,0
UD Oliveirense,76,0,272,126,0,484,0,42,140,46,64,0,0,0,140,46,64
Benfica II,138,42,464,138,42,480,28,46,132,0,84,0,0,0,132,0,84
Vitória Guimarães B,138,0,138,138,0,180,0,46,46,80,42,0,0,0,46,80,42
Atlético CP,46,42,88,138,126,264,46,46,88,0,0,0,0,0,88,0,0
Marítimo II,42,42,42,126,126,126,42,42,42,0,0,0,0,0,42,0,0
Sporting Braga II,42,38,122,42,0,80,0,0,0,42,80,0,0,0,0,42,80
Porto II,46,38,130,0,0,0,0,0,0,130,0,0,0,0,0,130,0
Sporting CP II,42,0,42,46,0,46,0,0,0,42,46,0,0,0,0,42,46
Cova Piedade,38,0,38,0,0,0,0,0,0,66,0,0,0,0,0,66,0
Real Sport Clube,152,152,152,114,114,114,38,38,38,0,0,0,0,0,38,0,0
Mafra,72,72,72,72,72,72,24,24,24,0,0,0,0,0,24,0,0
Ascoli,64,20,990,62,18,1077,2,5,187,121,146,78,239,136,265,360,282
Atalanta,98,25,1412,81,26,1546,4,9,262,114,161,145,228,164,407,342,325
Bologna,58,28,1065,84,22,1180,4,6,194,134,138,105,218,145,299,352,283
Cesena,66,24,1000,74,22,1092,1,5,187,103,163,72,229,152,259,332,315
Cremonese,63,27,523,70,20,558,2,8,90,74,93,36,133,87,126,207,180
Fiorentina,72,29,1420,74,22,1449,5,6,251,95,150,131,211,153,382,306,303
Genoa,72,27,1446,78,32,1487,5,5,264,131,186,107,286,188,371,417,374
Hellas Verona,67,24,1171,82,25,1294,4,8,225,120,152,103,236,158,328,356,310
Inter,81,28,1628,97,42,1792,11,14,300,71,116,213,137,137,513,208,253
Juventus,86,45,1772,102,50,2026,8,15,357,41,92,238,101,149,595,142,241
Lazio,89,33,1505,78,39,1552,6,8,268,99,119,164,186,137,432,285,256
Lecce,70,20,974,83,14,1015,6,6,163,120,126,94,196,118,257,316,244
Milan,85,36,1576,88,43,1796,4,11,297,75,115,214,125,148,511,200,263
Napoli,94,25,1583,91,14,1734,4,10,298,79,158,173,200,163,471,279,321
Roma,90,35,1633,87,41,1738,3,11,294,73,121,193,137,156,487,210,277
SSC Bari,65,26,1164,80,24,1333,3,6,220,120,170,113,234,164,333,354,334
Sampdoria,64,33,1487,71,36,1562,4,5,271,124,153,139,230,179,410,354,332
Udinese,65,32,1267,70,33,1314,5,8,221,131,141,125,233,135,346,364,276
Cagliari,83,29,1289,86,22,1358,5,7,234,133,173,109,274,156,343,407,329
Parma,65,29,1156,76,20,1286,3,7,225,101,130,113,199,142,338,300,272
Pisa,61,23,404,71,30,498,2,6,78,42,71,41,80,70,119,122,141
Torino,71,27,1418,83,27,1600,5,8,272,125,169,139,229,198,411,354,367
Calcio Foggia,67,31,516,72,34,530,3,4,95,40,67,40,104,58,135,144,125
Ancona,56,21,633,61,13,654,3,6,124,60,82,39,144,83,163,204,165
Brescia,69,18,1395,72,12,1496,4,5,252,127,183,122,248,191,374,375,374
Pescara,90,27,1282,83,18,1269,1,7,223,155,151,96,273,161,319,428,312
Piacenza,57,29,740,71,37,891,3,6,158,77,96,68,146,117,226,223,213
Reggiana,52,24,385,71,18,483,2,4,79,40,82,35,106,59,114,146,141
Padova,63,26,619,64,24,714,1,4,120,57,113,51,151,88,171,208,201
Vicenza ,69,30,975,68,36,1109,2,6,173,105,159,98,203,137,271,308,296
Perugia,67,38,628,74,32,707,2,7,118,50,82,63,105,82,181,155,164
Empoli,88,26,1149,85,30,1254,3,6,217,93,135,112,203,132,329,296,267
Chievo,77,25,1038,85,20,1194,4,6,180,133,158,113,199,157,293,332,315
Venezia,62,30,673,69,18,776,4,6,130,76,101,56,133,117,186,209,218
Modena,65,27,797,72,30,923,2,4,156,76,132,67,175,122,223,251,254
Reggina,63,29,733,68,29,864,2,4,137,88,122,71,159,118,208,247,240
Siena,67,33,557,77,31,623,3,5,104,68,77,49,113,87,153,181,164
Livorno,77,27,711,80,21,720,1,5,109,91,100,69,145,86,178,236,186
Messina,74,28,367,82,26,415,3,4,76,33,68,21,101,56,97,134,124
Palermo FC,78,32,1069,86,26,1161,3,6,211,93,122,87,193,145,298,286,267
Treviso,58,24,443,64,21,466,1,4,83,53,66,26,103,73,109,156,139
Catania,67,33,602,78,32,641,5,6,129,56,72,34,143,80,163,199,152
Novara,73,35,358,70,32,380,3,7,62,37,46,36,69,40,98,106,86
Sassuolo,78,29,693,85,34,715,5,5,102,72,78,86,95,73,188,167,151
Carpi,59,32,258,80,29,320,2,5,44,34,43,38,52,31,82,86,74
Frosinone,65,29,569,74,25,617,2,6,103,65,74,56,119,66,159,184,140
Crotone,63,34,807,82,15,839,4,5,150,92,95,70,185,84,220,277,179
Benevento,67,30,247,86,21,263,7,7,44,28,21,30,41,20,74,69,41
SPAL,66,27,245,78,20,267,6,6,38,36,39,28,56,30,66,92,69
Spezia,59,38,530,67,32,583,4,4,96,57,67,51,94,75,147,151,142
AC Monza,48,24,285,52,28,331,3,3,49,33,67,23,79,48,72,112,115
Avellino,52,27,539,59,36,602,2,6,112,69,86,33,153,81,145,222,167
Barletta,29,24,53,43,36,79,2,2,16,7,15,1,24,13,17,31,28
Catanzaro,40,16,82,28,26,82,2,2,11,28,22,4,42,15,15,70,37
Como,53,16,167,74,33,207,2,6,32,36,33,16,55,30,48,91,63
Cosenza Calcio,49,27,502,60,36,623,2,5,115,43,89,35,128,84,150,171,173
Licata,22,22,22,34,34,34,1,1,6,4,9,0,12,7,6,16,16
Triestina ,55,33,476,64,37,552,2,4,96,55,76,36,111,80,132,166,156
AS Lucchese Libertas 1905,49,29,332,54,37,401,2,3,65,23,83,17,82,72,82,105,155
Salernitana,65,28,850,72,23,926,3,5,164,90,119,63,185,126,227,275,245
Taranto,30,26,84,47,33,124,2,2,20,8,29,5,32,20,25,40,49
Casertana,31,31,31,43,43,43,1,1,6,3,10,2,8,9,8,11,19
Fidelis Andria,42,27,208,48,38,262,3,3,38,19,57,14,51,49,52,70,106
Ternana Calcio,64,25,691,69,22,737,2,4,119,75,111,56,148,101,175,223,212
Acireale,32,27,59,43,41,84,2,2,16,6,16,2,22,14,18,28,30
Ravenna FC,48,33,289,55,25,298,2,3,47,36,52,22,74,39,69,110,91
Pistoiese,46,35,158,49,32,159,2,2,25,26,25,13,43,20,38,69,45
Castel Sangro,29,29,29,44,44,44,2,2,11,5,3,1,13,5,12,18,8
Castel di Sangro,38,38,38,30,30,30,2,2,2,7,10,3,11,5,5,18,15
AlzanoCene,39,39,39,42,42,42,2,2,9,5,5,1,11,7,10,16,12
FC Savoia 1908,36,36,36,29,29,29,1,1,5,6,8,1,15,3,6,21,11
Fermana,36,36,36,29,29,29,1,1,6,7,6,0,14,5,6,21,11
Cittadella,62,39,691,66,37,721,4,5,109,83,88,73,121,87,182,204,175
AlbinoLeffe,67,38,455,78,30,479,2,5,71,49,71,48,93,51,119,142,122
AC Arezzo,51,42,138,66,51,168,5,5,27,13,23,14,27,22,41,40,45
Mantova,56,41,236,69,48,293,1,5,50,18,37,21,41,43,71,59,80
Rimini,68,42,208,69,48,234,2,5,38,18,28,23,38,23,61,56,51
Grosseto,66,43,311,64,34,308,1,3,50,27,49,22,61,43,72,88,92
Gallipoli ,43,43,43,40,40,40,2,2,6,11,4,4,11,6,10,22,10
Calcio Portogruaro-Summaga,39,39,39,40,40,40,2,2,6,9,6,4,13,4,10,22,10
Varese,57,40,254,71,39,286,1,4,47,26,32,26,44,35,73,70,67
AS Gubbio 1910,37,37,37,32,32,32,1,1,6,8,7,1,16,4,7,24,11
Juve Stabia,54,37,191,61,19,171,2,4,28,28,26,13,47,22,41,75,48
Nocerina,52,52,52,40,40,40,2,2,6,10,5,4,12,5,10,22,10
Pro Vercelli,47,35,208,49,33,217,2,2,35,33,37,15,60,30,50,93,67
Virtus Lanciano,50,43,186,60,48,206,3,3,31,20,33,15,34,35,46,54,68
Latina,44,38,164,68,39,203,2,4,29,24,31,16,31,37,45,55,68
Trapani,64,45,271,73,44,273,3,8,46,22,35,22,47,34,68,69,69
Virtus Entella,54,25,254,64,22,279,3,3,49,35,36,17,57,45,66,92,81
Nuova Cosenza,50,26,110,46,32,124,1,5,15,17,22,13,22,18,28,39,40
Pordenone,48,33,81,58,37,95,3,3,14,6,14,10,17,9,24,23,23
